0 2600 55 525
w1 w1 w1 w1 w1 w1 w1 w1 w1 f1 f1 f1 f1 f1 f1 f1 f1 f1 f1 f1 f1 f1 f1 f1 f1 f1 f1 f1 f1 f1 f1 f1 f1 f1 f1 f1 f1 f1 f1 f1 f1 f1 f1 f1 f1 f1 f1 f1 f1 f1 
w1 w1 w1 w1 w1 w1 w1 w1 w1 f1 f1 f1 f1 f1 f1 f1 f1 f1 f1 f1 f1 f1 f1 f1 f1 f1 f1 f1 f1 f1 f1 f1 f1 f1 f1 f1 f1 f1 f1 f1 f1 f1 f1 f1 f1 f1 f1 f1 f1 f1 
w1 w1 w1 w1 w1 w1 w1 w1 w1 f1 f1 f1 f1 f1 f1 f1 f1 f1 f1 f1 f1 f1 f1 f1 f1 f1 f1 f1 f1 f1 f1 f1 f1 f1 f1 f1 f1 f1 f1 f1 f1 f1 f1 f1 f1 f1 f1 f1 f1 f1 
w1 w1 f1 f1 f1 w1 w1 w1 w1 f1 f1 f1 f1 f1 f1 f1 f1 f1 f1 f1 f1 f1 f1 f1 f1 f1 f1 f1 f1 f1 f1 f1 f1 f1 f1 f1 f1 f1 f1 f1 f1 f1 f1 f1 f1 f1 f1 f1 f1 f1 
w1 w1 f1 f1 f1 w1 w1 w1 w1 f1 f1 f1 f1 f1 f1 f1 f1 f1 f1 f1 f1 f1 f1 f1 f1 f1 f1 f1 f1 f1 f1 f1 f1 f1 f1 f1 f1 f1 f1 f1 f1 f1 f1 f1 f1 f1 f1 f1 f1 f1 
w1 w1 f1 w1 f1 w1 w1 w1 w1 f1 f1 f1 f1 f1 w1 w1 w1 w1 f1 f1 f1 f1 f1 w1 w1 w1 w1 f1 f1 f1 f1 f1 w1 w1 w1 w1 f1 f1 f1 f1 f1 w1 w1 w1 w1 f1 f1 f1 f1 f1 
w1 w1 f1 f1 f1 w1 w1 w1 w1 f1 f1 f1 f1 f1 w1 w1 w1 w1 f1 f1 f1 f1 f1 w1 w1 w1 w1 f1 f1 f1 f1 f1 w1 w1 w1 w1 f1 f1 f1 f1 f1 w1 w1 w1 w1 f1 f1 f1 f1 f1 
w1 w1 f1 f1 f1 w1 w1 w1 w1 f1 f1 f1 f1 f1 w1 w1 w1 w1 f1 f1 f1 f1 f1 w1 w1 w1 w1 f1 f1 f1 f1 f1 w1 w1 w1 w1 f1 f1 f1 f1 f1 w1 w1 w1 w1 f1 f1 f1 f1 f1 
w1 w1 f1 f1 f1 w1 w1 w1 w1 f1 f1 f1 f1 f1 w1 w1 w1 w1 f1 f1 f1 f1 f1 w1 w1 w1 w1 f1 f1 f1 f1 f1 w1 w1 w1 w1 f1 f1 f1 f1 f1 w1 w1 w1 w1 f1 f1 f1 f1 f1 
w1 w1 f1 f1 f1 w1 w1 w1 w1 f1 f1 f1 f1 f1 f1 f1 f1 f1 f1 f1 f1 f1 f1 f1 f1 f1 f1 f1 f1 f1 f1 f1 f1 f1 f1 f1 f1 f1 f1 f1 f1 f1 f1 f1 f1 f1 f1 f1 f1 f1 
w1 w1 f1 f1 f1 w1 w1 w1 w1 f1 f1 f1 f1 f1 f1 f1 f1 f1 f1 f1 f1 f1 f1 f1 f1 f1 f1 f1 f1 f1 f1 f1 f1 f1 f1 f1 f1 f1 f1 f1 f1 f1 f1 f1 f1 f1 f1 f1 f1 f1 
w1 w1 f1 f1 f1 w1 w1 w1 w1 f1 f1 f1 f1 f1 f1 f1 f1 f1 f1 f1 f1 f1 f1 f1 f1 f1 f1 f1 f1 f1 f1 f1 f1 f1 f1 f1 f1 f1 f1 f1 f1 f1 f1 f1 f1 f1 f1 f1 f1 f1 
w1 w1 f1 f1 f1 w1 w1 w1 w1 f1 f1 f1 f1 f1 f1 f1 f1 f1 f1 f1 f1 f1 f1 f1 f1 f1 f1 f1 f1 f1 f1 f1 f1 f1 f1 f1 f1 f1 f1 f1 f1 f1 f1 f1 f1 f1 f1 f1 f1 f1 
w1 w1 f1 f1 f1 w1 w1 w1 w1 f1 f1 f1 f1 f1 f1 f1 f1 f1 f1 f1 f1 f1 f1 f1 f1 f1 f1 f1 f1 f1 f1 f1 f1 f1 f1 f1 f1 f1 f1 f1 f1 f1 f1 f1 f1 f1 f1 f1 f1 f1 
w1 w1 f1 f1 f1 w1 w1 w1 w1 f1 f1 f1 f1 f1 w1 w1 w1 w1 f1 f1 f1 f1 f1 w1 w1 w1 w1 f1 f1 f1 f1 f1 w1 w1 w1 w1 f1 f1 f1 f1 f1 w1 w1 w1 w1 f1 f1 f1 f1 f1 
w1 w1 f1 f1 f1 w1 w1 w1 w1 f1 f1 f1 f1 f1 w1 w1 w1 w1 f1 f1 f1 f1 f1 w1 w1 w1 w1 f1 f1 f1 f1 f1 w1 w1 w1 w1 f1 f1 f1 f1 f1 w1 w1 w1 w1 f1 f1 f1 f1 f1 
w1 w1 f1 f1 f1 w1 w1 w1 w1 f1 f1 f1 f1 f1 w1 w1 w1 w1 f1 f1 f1 f1 f1 w1 w1 w1 w1 f1 f1 f1 f1 f1 w1 w1 w1 w1 f1 f1 f1 f1 f1 w1 w1 w1 w1 f1 f1 f1 f1 f1 
w1 w1 f1 f1 f1 w1 w1 w1 w1 f1 f1 f1 f1 f1 w1 w1 w1 w1 f1 f1 f1 f1 f1 w1 w1 w1 w1 f1 f1 f1 f1 f1 w1 w1 w1 w1 f1 f1 f1 f1 f1 w1 w1 w1 w1 f1 f1 f1 f1 f1 
w1 w1 f1 f1 f1 w1 w1 w1 w1 f1 f1 f1 f1 f1 f1 f1 f1 f1 f1 f1 f1 f1 f1 f1 f1 f1 f1 f1 f1 f1 f1 f1 f1 f1 f1 f1 f1 f1 f1 f1 f1 f1 f1 f1 f1 f1 f1 f1 f1 f1 
w1 w1 f1 f1 f1 w1 w1 w1 w1 f1 f1 f1 f1 f1 f1 f1 f1 f1 f1 f1 f1 f1 f1 f1 f1 f1 f1 f1 f1 f1 f1 f1 f1 f1 f1 f1 f1 f1 f1 f1 f1 f1 f1 f1 f1 f1 f1 f1 f1 f1 
w1 w1 f1 f1 f1 w1 w1 w1 w1 f1 f1 f1 f1 f1 f1 f1 f1 f1 f1 f1 f1 f1 f1 f1 f1 f1 f1 f1 f1 f1 f1 f1 f1 f1 f1 f1 f1 f1 f1 f1 f1 f1 f1 f1 f1 f1 f1 f1 f1 f1 
w1 w1 f1 f1 f1 w1 w1 w1 w1 f1 f1 f1 f1 f1 f1 f1 f1 f1 f1 f1 f1 f1 f1 f1 f1 f1 f1 f1 f1 f1 f1 f1 f1 f1 f1 f1 f1 f1 f1 f1 f1 f1 f1 f1 f1 f1 f1 f1 f1 f1 
w1 w1 f1 f1 f1 w1 w1 w1 w1 f1 f1 f1 f1 f1 f1 f1 f1 f1 f1 f1 f1 f1 f1 f1 f1 f1 f1 f1 f1 f1 f1 f1 f1 f1 f1 f1 f1 f1 f1 f1 f1 f1 f1 f1 f1 f1 f1 f1 f1 f1 
w1 w1 f1 f1 f1 w1 w1 w1 w1 f1 f1 f1 f1 f1 w1 w1 w1 w1 f1 f1 f1 f1 f1 w1 w1 w1 w1 f1 f1 f1 f1 f1 w1 w1 w1 w1 f1 f1 f1 f1 f1 w1 w1 w1 w1 f1 f1 f1 f1 f1 
w1 w1 f1 f1 f1 w1 w1 w1 w1 f1 f1 f1 f1 f1 w1 w1 w1 w1 f1 f1 f1 f1 f1 w1 w1 w1 w1 f1 f1 f1 f1 f1 w1 w1 w1 w1 f1 f1 f1 f1 f1 w1 w1 w1 w1 f1 f1 f1 f1 f1 
w1 w1 f1 f1 f1 w1 w1 w1 w1 f1 f1 f1 f1 f1 w1 w1 w1 w1 f1 f1 f1 f1 f1 w1 w1 w1 w1 f1 f1 f1 f1 f1 w1 w1 w1 w1 f1 f1 f1 f1 f1 w1 w1 w1 w1 f1 f1 f1 f1 f1 
w1 w1 f1 f1 f1 w1 w1 w1 w1 f1 f1 f1 f1 f1 w1 w1 w1 w1 f1 f1 f1 f1 f1 w1 w1 w1 w1 f1 f1 f1 f1 f1 w1 w1 w1 w1 f1 f1 f1 f1 f1 w1 w1 w1 w1 f1 f1 f1 f1 f1 
w1 w1 f1 f1 f1 w1 w1 w1 w1 f1 f1 f1 f1 f1 f1 f1 f1 f1 f1 f1 f1 f1 f1 f1 f1 f1 f1 f1 f1 f1 f1 f1 f1 f1 f1 f1 f1 f1 f1 f1 f1 f1 f1 f1 f1 f1 f1 f1 f1 f1 
w1 w1 f1 f1 f1 w1 w1 w1 w1 f1 f1 f1 f1 f1 f1 f1 f1 f1 f1 f1 f1 f1 f1 f1 f1 f1 f1 f1 f1 f1 f1 f1 f1 f1 f1 f1 f1 f1 f1 f1 f1 f1 f1 f1 f1 f1 f1 f1 f1 f1 
w1 w1 f1 f1 f1 w1 w1 w1 w1 f1 f1 f1 f1 f1 f1 f1 f1 f1 f1 f1 f1 f1 f1 f1 f1 f1 f1 f1 f1 f1 f1 f1 f1 f1 f1 f1 f1 f1 f1 f1 f1 f1 f1 f1 f1 f1 f1 f1 f1 f1 
w1 w1 f1 f1 f1 w1 w1 w1 w1 f1 f1 f1 f1 f1 f1 f1 f1 f1 f1 f1 f1 f1 f1 f1 f1 f1 f1 f1 f1 f1 f1 f1 f1 f1 f1 f1 f1 f1 f1 f1 f1 f1 f1 f1 f1 f1 f1 f1 f1 f1 
w1 w1 f1 f1 f1 w1 w1 w1 w1 f1 f1 f1 f1 f1 f1 f1 f1 f1 f1 f1 f1 f1 f1 f1 f1 f1 f1 f1 f1 f1 f1 f1 f1 f1 f1 f1 f1 f1 f1 f1 f1 f1 f1 f1 f1 f1 f1 f1 f1 f1 
w1 w1 f1 f1 f1 w1 w1 w1 w1 f1 f1 f1 f1 f1 w1 w1 w1 w1 f1 f1 f1 f1 f1 w1 w1 w1 w1 f1 f1 f1 f1 f1 w1 w1 w1 w1 f1 f1 f1 f1 f1 w1 w1 w1 w1 f1 f1 f1 f1 f1 
w1 w1 f1 f1 f1 w1 w1 w1 w1 f1 f1 f1 f1 f1 w1 w1 w1 w1 f1 f1 f1 f1 f1 w1 w1 w1 w1 f1 f1 f1 f1 f1 w1 w1 w1 w1 f1 f1 f1 f1 f1 w1 w1 w1 w1 f1 f1 f1 f1 f1 
w1 w1 f1 f1 f1 w1 w1 w1 w1 f1 f1 f1 f1 f1 w1 w1 w1 w1 f1 f1 f1 f1 f1 w1 w1 w1 w1 f1 f1 f1 f1 f1 w1 w1 w1 w1 f1 f1 f1 f1 f1 w1 w1 w1 w1 f1 f1 f1 f1 f1 
w1 w1 f1 f1 f1 w1 w1 w1 w1 f1 f1 f1 f1 f1 w1 w1 w1 w1 f1 f1 f1 f1 f1 w1 w1 w1 w1 f1 f1 f1 f1 f1 w1 w1 w1 w1 f1 f1 f1 f1 f1 w1 w1 w1 w1 f1 f1 f1 f1 f1 
w1 w1 f1 f1 f1 w1 w1 w1 w1 f1 f1 f1 f1 f1 f1 f1 f1 f1 f1 f1 f1 f1 f1 f1 f1 f1 f1 f1 f1 f1 f1 f1 f1 f1 f1 f1 f1 f1 f1 f1 f1 f1 f1 f1 f1 f1 f1 f1 f1 f1 
w1 w1 f1 f1 f1 w1 w1 w1 w1 f1 f1 f1 f1 f1 f1 f1 f1 f1 f1 f1 f1 f1 f1 f1 f1 f1 f1 f1 f1 f1 f1 f1 f1 f1 f1 f1 f1 f1 f1 f1 f1 f1 f1 f1 f1 f1 f1 f1 f1 f1 
w1 w1 f1 f1 f1 w1 w1 w1 w1 f1 f1 f1 f1 f1 f1 f1 f1 f1 f1 f1 f1 f1 f1 f1 f1 f1 f1 f1 f1 f1 f1 f1 f1 f1 f1 f1 f1 f1 f1 f1 f1 f1 f1 f1 f1 f1 f1 f1 f1 f1 
w1 w1 f1 f1 f1 w1 w1 w1 w1 f1 f1 f1 f1 f1 f1 f1 f1 f1 f1 f1 f1 f1 f1 f1 f1 f1 f1 f1 f1 f1 f1 f1 f1 f1 f1 f1 f1 f1 f1 f1 f1 f1 f1 f1 f1 f1 f1 f1 f1 f1 
w1 w1 f1 f1 f1 w1 w1 w1 f1 f1 f1 f1 f1 f1 f1 f1 f1 f1 f1 f1 f1 f1 f1 f1 f1 f1 f1 f1 f1 f1 f1 f1 f1 f1 f1 f1 f1 f1 f1 f1 f1 f1 f1 f1 f1 f1 f1 f1 f1 f1 
w1 w1 f1 f1 f1 w1 w1 f1 f1 f1 w1 w1 w1 w1 w1 w1 w1 w1 w1 w1 w1 w1 w1 w1 w1 w1 w1 w1 w1 w1 w1 w1 w1 w1 w1 w1 w1 w1 w1 w1 w1 w1 w1 w1 w1 w1 w1 w1 w1 w1 
w1 w1 f1 f1 f1 w1 f1 f1 f1 w1 w1 w1 w1 w1 w1 w1 w1 w1 w1 w1 w1 w1 w1 w1 w1 w1 w1 w1 w1 w1 w1 w1 w1 w1 w1 w1 w1 w1 w1 w1 w1 w1 w1 w1 w1 w1 w1 w1 w1 w1 
w1 w1 f1 f1 f1 f1 f1 f1 w1 w1 w1 w1 w1 w1 w1 w1 w1 w1 w1 w1 w1 w1 w1 w1 w1 w1 w1 w1 w1 w1 w1 w1 w1 w1 w1 w1 w1 w1 w1 w1 w1 w1 w1 w1 w1 w1 w1 w1 w1 w1 
w1 w1 f1 f1 f1 w1 f1 w1 w1 w1 w1 w1 w1 w1 w1 w1 w1 w1 w1 w1 w1 w1 w1 w1 w1 w1 w1 w1 w1 w1 w1 w1 w1 w1 w1 w1 w1 w1 w1 w1 w1 w1 w1 w1 w1 w1 w1 w1 w1 w1 
w1 w1 f1 f1 f1 f1 f1 f1 f1 f1 f1 f1 f1 f1 f1 f1 f1 f1 f1 f1 f1 f1 f1 f1 f1 f1 f1 f1 f1 f1 f1 f1 f1 f1 f1 f1 f1 f1 f1 f1 f1 f1 f1 f1 f1 f1 f1 w1 w1 w1 
w1 w1 f1 f1 f1 f1 f1 f1 f1 f1 f1 f1 f1 f1 f1 f1 f1 f1 f1 f1 f1 f1 f1 f1 f1 f1 f1 f1 f1 f1 f1 f1 f1 f1 f1 f1 f1 f1 f1 f1 f1 f1 f1 f1 w1 f1 f1 w1 w1 w1 
w1 f1 f1 f1 f1 f1 f1 f1 f1 f1 f1 f1 f1 f1 f1 f1 f1 f1 f1 f1 f1 f1 f1 f1 f1 f1 f1 f1 f1 f1 f1 f1 f1 f1 f1 f1 f1 f1 f1 f1 f1 f1 f1 f1 f1 f1 f1 w1 w1 w1 
f1 f1 f1 w1 w1 w1 w1 w1 w1 w1 w1 w1 w1 w1 w1 w1 w1 w1 w1 w1 w1 w1 w1 w1 w1 w1 w1 w1 w1 w1 w1 w1 w1 w1 w1 w1 w1 w1 w1 w1 w1 w1 w1 w1 w1 w1 w1 w1 w1 w1 
f1 f1 w1 w1 w1 w1 w1 w1 w1 w1 w1 w1 w1 w1 w1 w1 w1 w1 w1 w1 w1 w1 w1 w1 w1 w1 w1 w1 w1 w1 w1 w1 w1 w1 w1 w1 w1 w1 w1 w1 w1 w1 w1 w1 w1 w1 w1 w1 w1 w1 