200 2498
w1 w1 w1 w1 w1 w1 w1 w1 w1 w1 w1 w1 w1 w1 w1 w1 w1 w1 w1 w1 w1 w1 w1 w1 w1 w1 w1 w1 w1 w1 w1 w1 w1 w1 w1 w1 w1 w1 w1 w1 w1 w1 w1 w1 w1 w1 w1 w1 w1 w1 
w1 w1 w1 w1 w1 w1 w1 w1 w1 w1 w1 w1 w1 w1 w1 w1 w1 w1 w1 w1 w1 w1 w1 w1 w1 w1 w1 w1 w1 w1 w1 w1 w1 w1 w1 w1 w1 w1 f1 f1 f1 f1 f1 f1 f1 w1 w1 w1 w1 w1 
w1 w1 w1 w1 w1 f1 f1 f1 f1 f1 f1 f1 f1 f1 f1 f1 f1 f1 f1 f1 f1 f1 f1 f1 f1 f1 f1 f1 f1 f1 f1 f1 f1 f1 f1 f1 f1 f1 f1 f1 f1 f1 f1 f1 f1 w1 w1 w1 w1 w1 
w1 w1 w1 w1 w1 f1 f1 f1 f1 f1 f1 f1 f1 f1 f1 f1 f1 f1 f1 f1 f1 f1 f1 f1 f1 f1 f1 f1 f1 f1 f1 f1 f1 f1 f1 f1 f1 f1 f1 f1 f1 f1 f1 f1 f1 w1 f1 f1 f1 w1 
w1 w1 w1 w1 w1 f1 f1 f1 f1 f1 f1 f1 f1 f1 f1 f1 f1 f1 f1 f1 f1 f1 f1 f1 f1 f1 f1 f1 f1 f1 f1 f1 f1 f1 f1 f1 f1 f1 f1 f1 f1 f1 f1 f1 f1 w1 f1 f1 f1 w1 
w1 w1 w1 w1 w1 f1 f1 f1 w1 w1 w1 w1 w1 w1 w1 w1 w1 w1 w1 w1 w1 w1 w1 w1 w1 w1 w1 w1 w1 w1 w1 w1 w1 w1 w1 w1 w1 w1 f1 f1 f1 f1 f1 f1 f1 w1 f1 f1 f1 w1 
f1 f1 f1 f1 f1 f1 f1 f1 w1 w1 w1 w1 w1 w1 w1 w1 w1 w1 w1 w1 w1 w1 w1 w1 w1 w1 w1 w1 w1 w1 w1 w1 w1 w1 w1 w1 w1 w1 f1 f1 w1 w1 w1 f1 f1 w1 f1 f1 f1 w1 
f1 f1 f1 f1 f1 f1 f1 f1 w1 w1 f1 f1 f1 f1 f1 f1 f1 f1 w1 w1 f1 f1 f1 f1 f1 f1 f1 f1 f1 f1 f1 f1 f1 f1 f1 f1 w1 w1 f1 f1 w1 w1 w1 f1 f1 w1 f1 f1 f1 w1 
f1 f1 f1 f1 f1 f1 f1 f1 w1 w1 f1 f1 f1 f1 f1 f1 f1 f1 w1 w1 f1 f1 f1 f1 f1 f1 f1 f1 f1 f1 f1 f1 f1 f1 f1 f1 w1 w1 f1 f1 w1 w1 w1 f1 f1 w1 f1 f1 f1 w1 
f1 f1 f1 f1 f1 f1 f1 f1 w1 w1 f1 f1 f1 w1 w1 f1 f1 f1 w1 w1 f1 f1 f1 f1 f1 f1 f1 f1 f1 f1 f1 f1 f1 f1 f1 f1 w1 w1 f1 f1 w1 w1 w1 f1 f1 w1 f1 f1 f1 w1 
w1 w1 w1 w1 w1 f1 f1 f1 w1 w1 f1 f1 f1 w1 w1 f1 f1 f1 w1 w1 f1 f1 f1 f1 f1 f1 f1 f1 w1 w1 f1 f1 f1 f1 f1 f1 w1 w1 f1 f1 w1 w1 w1 f1 f1 w1 f1 f1 f1 w1 
w1 w1 w1 w1 w1 f1 f1 f1 w1 w1 f1 f1 f1 w1 w1 f1 f1 f1 w1 w1 f1 f1 f1 f1 f1 f1 f1 f1 w1 w1 f1 f1 f1 f1 f1 f1 w1 w1 f1 f1 w1 w1 w1 f1 f1 w1 f1 f1 f1 w1 
w1 w1 w1 w1 w1 f1 f1 f1 w1 w1 w1 w1 w1 w1 w1 f1 f1 f1 w1 w1 f1 f1 f1 f1 f1 f1 f1 f1 f1 f1 f1 f1 f1 f1 f1 f1 w1 w1 f1 f1 w1 w1 w1 f1 f1 w1 f1 f1 f1 w1 
w1 w1 w1 w1 w1 f1 f1 f1 w1 w1 w1 w1 w1 w1 w1 f1 f1 f1 w1 w1 f1 f1 f1 f1 f1 f1 f1 f1 f1 f1 f1 f1 f1 f1 f1 f1 w1 w1 f1 f1 w1 w1 w1 f1 f1 w1 f1 f1 f1 w1 
w1 w1 w1 w1 w1 f1 f1 f1 w1 w1 f1 f1 f1 f1 f1 f1 f1 f1 f1 f1 f1 f1 f1 f1 f1 f1 f1 f1 f1 f1 f1 f1 f1 f1 f1 f1 w1 w1 f1 f1 w1 w1 w1 f1 f1 w1 f1 f1 f1 w1 
w1 w1 w1 w1 w1 f1 f1 f1 w1 w1 f1 f1 f1 f1 f1 f1 f1 f1 f1 f1 f1 f1 f1 f1 f1 f1 f1 f1 f1 f1 f1 f1 f1 f1 f1 f1 w1 w1 f1 f1 w1 w1 w1 f1 f1 w1 f1 f1 f1 w1 
w1 w1 w1 w1 w1 f1 f1 f1 w1 w1 f1 f1 f1 f1 f1 f1 f1 f1 f1 f1 f1 f1 f1 f1 f1 f1 f1 f1 f1 f1 f1 f1 f1 f1 f1 f1 w1 w1 f1 f1 w1 w1 w1 f1 f1 w1 f1 f1 f1 w1 
w1 w1 w1 w1 w1 f1 f1 f1 w1 w1 f1 f1 f1 f1 f1 f1 f1 f1 f1 f1 f1 f1 f1 f1 f1 f1 f1 f1 f1 f1 f1 f1 f1 f1 f1 f1 w1 w1 f1 f1 w1 w1 w1 f1 f1 w1 f1 f1 f1 w1 
w1 w1 w1 w1 w1 f1 f1 f1 w1 w1 f1 f1 f1 f1 f1 w1 w1 f1 f1 f1 f1 f1 f1 f1 f1 f1 f1 f1 f1 f1 f1 f1 f1 f1 f1 f1 w1 w1 f1 f1 w1 w1 w1 f1 f1 w1 f1 f1 f1 w1 
w1 w1 w1 w1 w1 f1 f1 f1 w1 w1 f1 f1 f1 f1 f1 w1 w1 f1 f1 f1 f1 f1 f1 f1 f1 f1 f1 f1 f1 f1 f1 f1 f1 f1 f1 f1 w1 w1 f1 f1 w1 w1 w1 f1 f1 w1 f1 f1 f1 w1 
w1 w1 w1 w1 w1 f1 f1 f1 w1 w1 f1 f1 f1 f1 f1 f1 f1 f1 f1 f1 f1 f1 f1 f1 f1 f1 f1 f1 f1 f1 f1 f1 f1 f1 f1 f1 w1 w1 f1 f1 w1 w1 w1 f1 f1 w1 f1 f1 f1 w1 
w1 w1 w1 w1 w1 f1 f1 f1 w1 w1 f1 f1 f1 f1 f1 f1 f1 f1 f1 f1 f1 f1 f1 f1 f1 f1 f1 w1 w1 f1 f1 f1 f1 f1 f1 f1 w1 w1 f1 f1 w1 w1 w1 f1 f1 w1 f1 f1 f1 w1 
w1 w1 w1 w1 w1 f1 f1 f1 w1 w1 f1 f1 f1 f1 f1 f1 f1 f1 f1 f1 f1 f1 f1 f1 f1 f1 f1 w1 w1 f1 f1 f1 f1 f1 f1 f1 w1 w1 f1 f1 w1 w1 w1 f1 f1 w1 f1 f1 f1 w1 
w1 w1 w1 w1 w1 f1 f1 f1 w1 w1 f1 f1 f1 f1 f1 f1 f1 f1 f1 f1 f1 f1 f1 f1 f1 f1 f1 f1 f1 f1 f1 f1 f1 f1 f1 f1 w1 w1 f1 f1 w1 w1 w1 f1 f1 w1 f1 f1 f1 w1 
w1 w1 w1 w1 w1 f1 f1 f1 w1 w1 f1 f1 f1 f1 f1 f1 f1 f1 f1 f1 f1 f1 f1 f1 f1 f1 f1 f1 f1 f1 f1 f1 f1 f1 f1 f1 w1 w1 f1 f1 w1 w1 w1 f1 f1 w1 f1 f1 f1 w1 
w1 w1 w1 w1 w1 f1 f1 f1 w1 w1 f1 f1 f1 f1 f1 f1 f1 f1 f1 f1 f1 w1 w1 f1 f1 f1 f1 f1 f1 f1 f1 f1 f1 f1 f1 f1 w1 w1 f1 f1 w1 w1 w1 f1 f1 w1 f1 f1 f1 w1 
w1 w1 w1 w1 w1 f1 f1 f1 w1 w1 f1 f1 f1 f1 f1 f1 f1 f1 f1 f1 f1 w1 w1 f1 f1 f1 f1 f1 f1 f1 f1 f1 f1 f1 f1 f1 w1 w1 f1 f1 w1 w1 w1 f1 f1 w1 f1 f1 f1 w1 
w1 w1 w1 w1 w1 f1 f1 f1 w1 w1 f1 f1 f1 f1 f1 f1 f1 f1 f1 f1 f1 f1 f1 f1 f1 f1 f1 f1 f1 f1 f1 f1 f1 f1 f1 f1 w1 w1 f1 f1 w1 w1 w1 f1 f1 w1 f1 f1 f1 w1 
w1 w1 w1 w1 w1 f1 f1 f1 w1 w1 f1 f1 f1 f1 f1 f1 f1 f1 f1 f1 f1 f1 f1 f1 f1 f1 f1 f1 f1 f1 f1 f1 f1 f1 f1 f1 w1 w1 f1 f1 w1 w1 w1 f1 f1 w1 f1 f1 f1 w1 
w1 w1 w1 w1 w1 f1 f1 f1 w1 w1 f1 f1 f1 f1 f1 f1 f1 f1 f1 f1 f1 f1 f1 f1 f1 f1 f1 f1 f1 f1 f1 f1 f1 f1 f1 f1 w1 w1 f1 f1 w1 w1 w1 f1 f1 w1 f1 f1 f1 w1 
w1 w1 w1 w1 w1 f1 f1 f1 w1 w1 f1 f1 f1 f1 f1 w1 w1 w1 f1 f1 f1 f1 f1 f1 f1 f1 f1 f1 f1 f1 f1 f1 f1 f1 f1 f1 f1 f1 f1 f1 f1 f1 f1 f1 f1 w1 f1 f1 f1 w1 
w1 w1 w1 w1 w1 f1 f1 f1 w1 w1 f1 f1 f1 f1 f1 w1 w1 w1 f1 f1 f1 f1 f1 f1 f1 f1 f1 f1 f1 f1 f1 f1 f1 f1 f1 f1 f1 f1 f1 f1 f1 f1 f1 f1 f1 w1 f1 f1 f1 w1 
w1 w1 w1 w1 w1 f1 f1 f1 w1 w1 f1 f1 f1 f1 f1 w1 w1 w1 f1 f1 f1 f1 f1 f1 f1 f1 w1 w1 w1 w1 f1 f1 f1 f1 f1 f1 f1 f1 f1 f1 f1 f1 f1 f1 f1 w1 f1 f1 f1 w1 
w1 w1 w1 w1 w1 f1 f1 f1 w1 w1 f1 f1 f1 f1 f1 f1 f1 f1 f1 f1 f1 f1 f1 f1 f1 f1 w1 w1 w1 w1 f1 f1 f1 f1 f1 f1 f1 f1 f1 w1 w1 w1 w1 w1 w1 w1 f1 f1 f1 w1 
w1 w1 w1 w1 w1 f1 f1 f1 w1 w1 f1 f1 f1 f1 f1 f1 f1 f1 f1 f1 f1 f1 f1 f1 f1 f1 w1 w1 w1 w1 f1 f1 f1 f1 f1 f1 f1 f1 f1 w1 w1 w1 w1 w1 w1 w1 f1 f1 f1 w1 
w1 w1 w1 w1 w1 f1 f1 f1 w1 w1 f1 f1 f1 f1 f1 f1 f1 f1 f1 f1 f1 f1 f1 f1 f1 f1 w1 w1 w1 w1 f1 f1 f1 f1 f1 f1 f1 f1 f1 w1 w1 f1 f1 f1 w1 w1 f1 f1 f1 w1 
w1 w1 w1 w1 w1 f1 f1 f1 w1 w1 f1 f1 f1 f1 f1 f1 f1 f1 f1 f1 f1 f1 f1 f1 f1 f1 f1 f1 f1 f1 f1 f1 f1 f1 f1 f1 f1 f1 f1 f1 f1 f1 f1 f1 f1 f1 f1 f1 f1 w1 
w1 w1 w1 w1 w1 f1 f1 f1 w1 w1 f1 f1 f1 f1 f1 f1 f1 f1 f1 f1 f1 f1 f1 f1 f1 f1 f1 f1 f1 f1 f1 f1 f1 f1 f1 f1 f1 f1 f1 f1 f1 f1 f1 f1 f1 f1 f1 f1 f1 w1 
w1 w1 w1 w1 w1 f1 f1 f1 w1 w1 f1 f1 f1 f1 f1 f1 f1 f1 f1 f1 f1 f1 f1 f1 f1 f1 f1 f1 f1 f1 f1 f1 f1 f1 f1 f1 f1 f1 f1 w1 w1 f1 f1 f1 w1 w1 f1 f1 f1 w1 
w1 w1 w1 w1 w1 f1 f1 f1 w1 w1 f1 f1 f1 f1 f1 f1 f1 f1 f1 f1 f1 f1 f1 f1 f1 f1 f1 f1 f1 f1 f1 f1 f1 f1 f1 f1 f1 f1 f1 w1 w1 w1 w1 w1 w1 w1 f1 f1 f1 w1 
w1 w1 w1 w1 w1 f1 f1 f1 w1 w1 w1 w1 w1 w1 w1 w1 w1 w1 w1 w1 w1 w1 w1 w1 w1 w1 w1 w1 w1 w1 w1 w1 w1 w1 w1 w1 w1 w1 w1 w1 w1 w1 w1 w1 w1 w1 f1 f1 f1 w1 
w1 w1 w1 w1 w1 f1 f1 f1 w1 w1 w1 w1 w1 w1 w1 w1 w1 w1 w1 w1 w1 w1 w1 w1 w1 w1 w1 w1 w1 w1 w1 w1 w1 w1 w1 w1 w1 w1 w1 w1 w1 w1 w1 w1 w1 w1 f1 f1 f1 w1 
w1 f1 f1 f1 f1 f1 f1 f1 f1 f1 f1 f1 f1 f1 f1 f1 f1 f1 f1 f1 f1 f1 f1 f1 f1 f1 f1 f1 f1 f1 f1 f1 f1 f1 f1 f1 f1 f1 f1 f1 f1 f1 f1 f1 w1 w1 f1 f1 f1 w1 
w1 f1 f1 f1 f1 f1 f1 f1 f1 f1 f1 f1 f1 f1 f1 f1 f1 f1 f1 f1 f1 f1 f1 f1 f1 f1 f1 f1 f1 f1 f1 f1 f1 f1 f1 f1 f1 f1 f1 f1 f1 f1 f1 f1 w1 w1 f1 f1 f1 w1 
w1 f1 f1 f1 f1 f1 f1 f1 f1 f1 f1 f1 f1 f1 f1 f1 f1 f1 f1 f1 f1 f1 f1 f1 f1 f1 f1 f1 f1 f1 f1 f1 f1 f1 f1 f1 f1 f1 f1 f1 f1 f1 f1 f1 w1 w1 f1 f1 f1 w1 
w1 w1 w1 w1 w1 f1 f1 f1 w1 w1 f1 f1 w1 w1 w1 w1 w1 w1 w1 w1 w1 w1 w1 w1 w1 w1 w1 w1 w1 w1 w1 w1 w1 w1 w1 w1 w1 w1 w1 w1 w1 w1 w1 w1 w1 w1 f1 f1 f1 w1 
w1 w1 w1 w1 w1 f1 f1 f1 w1 w1 f1 f1 w1 w1 w1 w1 w1 w1 w1 w1 w1 w1 w1 w1 w1 w1 w1 w1 w1 w1 w1 w1 w1 w1 w1 w1 w1 w1 w1 w1 w1 w1 w1 w1 w1 w1 f1 f1 f1 w1 
w1 w1 w1 w1 w1 f1 f1 f1 w1 w1 f1 f1 f1 f1 f1 f1 f1 f1 f1 f1 f1 f1 f1 f1 f1 f1 f1 f1 f1 f1 f1 f1 f1 f1 f1 f1 f1 f1 f1 f1 f1 f1 f1 f1 f1 f1 f1 f1 f1 w1 
w1 w1 w1 w1 w1 f1 f1 f1 w1 w1 f1 f1 f1 f1 f1 f1 f1 f1 f1 f1 f1 f1 f1 f1 f1 f1 f1 f1 f1 f1 f1 f1 f1 f1 f1 f1 f1 f1 f1 f1 f1 f1 f1 f1 f1 f1 f1 f1 f1 w1 
w1 w1 w1 w1 w1 f1 f1 f1 w1 w1 w1 w1 w1 w1 w1 w1 w1 w1 w1 w1 w1 w1 w1 w1 w1 w1 w1 w1 w1 w1 w1 w1 w1 w1 w1 w1 w1 w1 w1 w1 w1 w1 w1 w1 w1 w1 w1 w1 w1 w1 