2128 2458 475 350
w1 w1 w1 w1 w1 w1 f1 f1 f1 f1 f1 f1 f1 w1 w1 w1 w1 w1 w1 w1 w1 w1 w1 w1 w1 w1 w1 w1 w1 w1 w1 w1 w1 w1 w1 w1 w1 w1 w1 w1 w1 w1 w1 w1 w1 w1 w1 w1 w1 w1 
w1 w1 w1 w1 w1 w1 f1 f1 f1 f1 f1 f1 f1 w1 w1 w1 w1 w1 w1 w1 w1 w1 w1 w1 w1 w1 w1 w1 w1 w1 w1 w1 w1 w1 w1 w1 w1 w1 w1 f1 f1 f1 f1 f1 f1 f1 f1 f1 f1 w1
w1 w1 w1 w1 w1 w1 f1 f1 f1 f1 f1 f1 f1 w1 w1 w1 w1 w1 w1 w1 w1 w1 w1 w1 w1 w1 w1 w1 w1 w1 w1 w1 w1 w1 w1 w1 w1 w1 w1 f1 f1 f1 f1 f1 f1 f1 f1 f1 f1 w1 
w1 w1 w1 w1 w1 w1 f1 f1 f1 f1 f1 f1 f1 f1 f1 f1 f1 f1 f1 f1 f1 f1 f1 f1 f1 f1 f1 f1 f1 f1 f1 f1 f1 f1 f1 f1 f1 f1 f1 f1 f1 f1 f1 f1 f1 f1 f1 f1 f1 w1 
w1 w1 w1 w1 w1 w1 f1 f1 f1 f1 f1 f1 f1 f1 f1 f1 f1 f1 f1 f1 f1 f1 f1 f1 f1 f1 f1 f1 f1 f1 f1 f1 f1 f1 f1 f1 f1 f1 f1 f1 f1 f1 f1 f1 f1 f1 f1 f1 f1 w1 
w1 w1 w1 w1 w1 w1 f1 f1 f1 f1 f1 f1 f1 w1 w1 w1 w1 w1 w1 w1 w1 w1 w1 w1 w1 w1 w1 w1 w1 w1 w1 w1 w1 w1 w1 w1 w1 w1 w1 f1 f1 f1 f1 f1 w1 w1 w1 f1 f1 w1 
w1 w1 w1 w1 w1 w1 f1 f1 f1 f1 f1 f1 f1 w1 w1 w1 w1 w1 w1 w1 w1 w1 w1 w1 w1 f1 f1 f1 f1 f1 f1 f1 f1 f1 f1 f1 f1 f1 f1 f1 f1 f1 f1 f1 w1 w1 w1 f1 f1 w1 
w1 f1 f1 f1 f1 f1 f1 f1 f1 f1 f1 f1 f1 w1 w1 w1 w1 w1 w1 w1 w1 w1 w1 w1 w1 f1 f1 f1 f1 f1 f1 f1 f1 f1 f1 f1 f1 f1 f1 f1 f1 f1 f1 f1 w1 w1 w1 f1 f1 w1 
w1 f1 f1 f1 f1 f1 f1 f1 f1 f1 f1 f1 f1 w1 w1 w1 w1 w1 w1 w1 w1 w1 w1 w1 w1 f1 f1 f1 f1 f1 f1 f1 f1 f1 f1 f1 f1 f1 f1 f1 f1 f1 f1 f1 w1 w1 w1 f1 f1 w1 
w1 f1 f1 f1 f1 f1 f1 f1 f1 f1 f1 f1 f1 w1 w1 w1 w1 w1 w1 w1 w1 w1 w1 w1 w1 f1 f1 f1 f1 f1 f1 w1 w1 w1 w1 w1 w1 w1 f1 f1 f1 f1 f1 f1 w1 w1 w1 f1 f1 w1 
w1 f1 f1 f1 f1 f1 f1 f1 f1 f1 f1 f1 f1 f1 f1 f1 f1 f1 f1 f1 f1 w1 w1 w1 w1 f1 f1 f1 f1 f1 f1 w1 w1 w1 w1 w1 w1 w1 f1 f1 f1 f1 f1 f1 w1 w1 w1 f1 f1 w1 
w1 f1 f1 f1 f1 f1 f1 f1 f1 f1 f1 f1 f1 f1 f1 f1 f1 f1 f1 f1 f1 w1 w1 w1 w1 f1 f1 f1 f1 f1 f1 w1 w1 w1 w1 w1 w1 w1 f1 f1 f1 f1 f1 f1 w1 w1 w1 f1 f1 w1 
w1 f1 f1 w1 w1 w1 w1 f1 f1 f1 f1 f1 f1 f1 f1 f1 f1 f1 f1 f1 f1 w1 w1 w1 w1 f1 f1 f1 f1 f1 f1 w1 w1 w1 w1 w1 w1 w1 f1 f1 f1 f1 f1 f1 w1 w1 w1 f1 f1 w1 
w1 f1 f1 w1 w1 w1 w1 f1 f1 f1 f1 f1 f1 f1 f1 f1 f1 f1 f1 f1 f1 w1 w1 w1 w1 f1 f1 f1 f1 f1 f1 w1 w1 w1 w1 w1 w1 w1 f1 f1 f1 f1 f1 f1 w1 w1 w1 f1 f1 w1 
w1 f1 f1 w1 w1 w1 w1 f1 f1 f1 f1 f1 f1 f1 f1 f1 f1 f1 f1 f1 f1 w1 w1 w1 w1 f1 f1 f1 f1 f1 f1 w1 w1 w1 w1 w1 w1 w1 f1 f1 f1 f1 f1 f1 w1 w1 w1 f1 f1 w1 
w1 f1 f1 w1 w1 w1 w1 f1 f1 f1 f1 f1 f1 f1 f1 f1 f1 f1 f1 f1 f1 w1 w1 w1 w1 f1 f1 f1 f1 f1 f1 w1 w1 w1 w1 w1 w1 w1 f1 f1 f1 f1 f1 f1 w1 w1 w1 f1 f1 w1 
w1 f1 f1 w1 w1 w1 w1 f1 f1 f1 f1 f1 f1 f1 f1 f1 f1 f1 f1 f1 f1 w1 w1 w1 w1 f1 f1 f1 f1 f1 f1 w1 w1 w1 w1 w1 w1 w1 f1 f1 f1 f1 f1 f1 w1 w1 w1 w1 w1 w1 
w1 f1 f1 w1 w1 w1 w1 f1 f1 f1 f1 w1 w1 w1 w1 w1 w1 f1 f1 f1 f1 w1 w1 w1 w1 f1 f1 f1 f1 f1 f1 w1 w1 w1 w1 w1 w1 w1 f1 f1 f1 f1 f1 f1 w1 w1 w1 w1 w1 w1 
w1 f1 f1 w1 w1 w1 w1 f1 f1 f1 f1 w1 w1 w1 w1 w1 w1 f1 f1 f1 f1 w1 w1 w1 w1 f1 f1 f1 f1 f1 f1 w1 w1 w1 w1 w1 w1 w1 f1 f1 f1 f1 f1 f1 w1 w1 w1 w1 w1 w1 
w1 f1 f1 w1 w1 w1 w1 f1 f1 f1 f1 w1 w1 w1 w1 w1 w1 f1 f1 f1 f1 w1 w1 w1 w1 f1 f1 f1 f1 f1 f1 w1 w1 w1 w1 w1 w1 w1 f1 f1 f1 f1 f1 f1 f1 f1 f1 f1 f1 w1 
w1 f1 f1 w1 w1 w1 w1 f1 f1 f1 f1 w1 w1 w1 w1 w1 w1 f1 f1 f1 f1 w1 w1 w1 w1 f1 f1 f1 f1 f1 f1 w1 w1 w1 w1 w1 w1 w1 f1 f1 f1 f1 f1 f1 f1 f1 f1 f1 f1 w1 
w1 f1 f1 w1 w1 w1 w1 f1 f1 f1 f1 w1 w1 w1 w1 w1 w1 f1 f1 f1 f1 w1 w1 w1 w1 f1 f1 f1 f1 f1 f1 w1 w1 w1 w1 w1 w1 w1 f1 f1 f1 f1 f1 f1 f1 f1 f1 f1 f1 w1 
w1 f1 f1 w1 w1 w1 w1 f1 f1 f1 f1 w1 w1 w1 w1 w1 w1 f1 f1 f1 f1 w1 w1 w1 w1 f1 f1 f1 f1 f1 f1 w1 w1 w1 w1 w1 w1 w1 f1 f1 f1 f1 f1 f1 f1 f1 f1 f1 f1 w1 
w1 f1 f1 w1 w1 w1 w1 f1 f1 f1 f1 w1 w1 w1 w1 w1 w1 f1 f1 f1 f1 w1 w1 w1 w1 f1 f1 f1 f1 f1 f1 f1 f1 f1 f1 f1 f1 f1 f1 f1 f1 f1 f1 f1 f1 f1 f1 f1 f1 w1 
w1 f1 f1 w1 w1 w1 w1 f1 f1 f1 f1 w1 w1 w1 w1 w1 w1 f1 f1 f1 f1 w1 w1 w1 w1 f1 f1 f1 f1 f1 f1 f1 f1 f1 f1 f1 f1 f1 f1 f1 f1 f1 f1 f1 f1 f1 f1 f1 f1 w1 
w1 f1 f1 w1 w1 w1 w1 f1 f1 f1 f1 w1 w1 w1 w1 w1 w1 f1 f1 f1 f1 w1 w1 w1 w1 f1 f1 f1 f1 f1 f1 f1 f1 f1 f1 f1 f1 f1 f1 f1 f1 f1 f1 f1 f1 f1 f1 f1 f1 w1 
w1 f1 f1 w1 w1 w1 w1 f1 f1 f1 f1 w1 w1 w1 w1 w1 w1 f1 f1 f1 f1 w1 w1 w1 w1 f1 f1 f1 f1 f1 f1 f1 f1 f1 f1 f1 f1 f1 f1 f1 f1 f1 f1 f1 f1 f1 f1 f1 f1 w1 
w1 f1 f1 w1 w1 w1 w1 f1 f1 f1 f1 w1 w1 w1 w1 w1 w1 f1 f1 f1 f1 w1 w1 w1 w1 f1 f1 f1 f1 f1 f1 f1 f1 f1 f1 f1 f1 f1 f1 f1 f1 f1 f1 f1 f1 f1 f1 f1 f1 w1 
w1 f1 f1 w1 w1 w1 w1 f1 f1 f1 f1 f1 f1 f1 f1 f1 f1 f1 f1 f1 f1 w1 w1 w1 w1 f1 f1 f1 f1 f1 f1 f1 f1 f1 f1 f1 f1 f1 f1 f1 f1 f1 f1 f1 f1 f1 f1 f1 f1 w1 
w1 f1 f1 w1 w1 w1 w1 f1 f1 f1 f1 f1 f1 f1 f1 f1 f1 f1 f1 f1 f1 w1 w1 w1 w1 w1 w1 w1 w1 w1 w1 w1 w1 w1 w1 w1 w1 w1 f1 f1 f1 f1 w1 w1 w1 w1 f1 f1 f1 w1 
w1 f1 f1 w1 w1 w1 w1 f1 f1 f1 f1 f1 f1 f1 f1 f1 f1 f1 f1 f1 f1 w1 w1 w1 w1 w1 w1 w1 w1 w1 w1 w1 w1 w1 w1 w1 w1 w1 f1 f1 f1 f1 w1 w1 w1 w1 f1 f1 f1 w1 
w1 f1 f1 w1 w1 w1 w1 f1 f1 f1 f1 f1 f1 f1 f1 f1 f1 f1 f1 f1 f1 w1 w1 w1 w1 w1 w1 w1 w1 w1 w1 w1 w1 w1 w1 w1 w1 w1 f1 f1 f1 f1 w1 w1 w1 w1 f1 f1 f1 w1 
w1 f1 f1 w1 w1 w1 w1 f1 f1 f1 f1 f1 f1 f1 f1 f1 f1 f1 f1 f1 f1 w1 w1 w1 w1 w1 w1 w1 w1 w1 w1 w1 w1 w1 w1 w1 w1 w1 f1 f1 f1 f1 w1 w1 w1 w1 f1 f1 f1 w1 
w1 f1 f1 w1 w1 w1 w1 f1 f1 f1 f1 f1 f1 f1 f1 f1 f1 f1 f1 f1 f1 w1 w1 w1 w1 w1 w1 w1 w1 w1 w1 w1 w1 w1 w1 w1 w1 w1 f1 f1 f1 f1 w1 w1 w1 w1 f1 f1 f1 w1 
w1 f1 f1 w1 w1 w1 w1 f1 f1 f1 f1 f1 f1 f1 f1 f1 f1 f1 f1 f1 f1 f1 f1 f1 f1 f1 f1 f1 f1 f1 f1 f1 f1 w1 w1 w1 w1 w1 f1 f1 f1 f1 w1 w1 w1 w1 f1 f1 f1 w1 
w1 f1 f1 w1 w1 w1 w1 f1 f1 f1 f1 f1 f1 f1 f1 f1 f1 f1 f1 f1 f1 f1 f1 f1 f1 f1 f1 f1 f1 f1 f1 f1 f1 w1 w1 w1 w1 w1 w1 w1 w1 w1 w1 w1 w1 w1 f1 f1 f1 w1 
w1 f1 f1 w1 w1 w1 w1 f1 f1 f1 f1 f1 f1 f1 f1 f1 f1 f1 f1 f1 f1 f1 f1 f1 f1 f1 f1 f1 f1 f1 f1 f1 f1 w1 w1 w1 w1 w1 w1 w1 w1 w1 w1 w1 w1 w1 f1 f1 f1 w1 
w1 w1 w1 w1 w1 w1 w1 w1 w1 w1 w1 w1 w1 w1 w1 w1 w1 w1 w1 w1 w1 w1 w1 w1 w1 w1 w1 w1 w1 f1 f1 f1 f1 w1 w1 w1 w1 w1 w1 w1 w1 w1 w1 w1 w1 w1 f1 f1 f1 w1 
w1 w1 w1 w1 w1 w1 w1 w1 w1 w1 w1 w1 w1 w1 w1 w1 w1 w1 w1 w1 w1 w1 w1 w1 w1 w1 w1 w1 w1 f1 f1 f1 f1 w1 w1 w1 w1 w1 w1 w1 w1 w1 w1 w1 w1 w1 f1 f1 f1 w1 
w1 w1 w1 w1 w1 w1 w1 w1 w1 w1 w1 w1 w1 w1 w1 w1 w1 w1 w1 w1 w1 w1 w1 w1 w1 w1 w1 w1 w1 f1 f1 f1 f1 w1 w1 w1 w1 w1 w1 w1 w1 f1 f1 f1 f1 f1 f1 f1 f1 w1 
w1 w1 w1 w1 w1 w1 w1 w1 w1 w1 w1 w1 w1 w1 w1 w1 w1 w1 w1 w1 w1 w1 w1 w1 w1 w1 w1 w1 w1 f1 f1 f1 f1 w1 w1 w1 w1 w1 w1 w1 w1 f1 f1 f1 f1 f1 f1 f1 f1 w1 
w1 f1 f1 f1 f1 f1 f1 f1 f1 f1 f1 f1 f1 f1 f1 f1 f1 f1 f1 f1 f1 f1 f1 f1 f1 f1 f1 f1 f1 f1 f1 f1 f1 f1 f1 f1 f1 f1 f1 f1 f1 f1 f1 f1 f1 f1 f1 f1 f1 w1 
w1 f1 f1 f1 f1 f1 f1 f1 f1 f1 f1 f1 f1 f1 f1 f1 f1 f1 f1 f1 f1 f1 f1 f1 f1 f1 f1 f1 f1 f1 f1 f1 f1 f1 f1 f1 f1 f1 f1 f1 f1 f1 f1 f1 f1 f1 f1 f1 f1 w1 
w1 f1 f1 f1 f1 f1 f1 f1 f1 f1 f1 f1 f1 f1 f1 f1 f1 f1 f1 f1 f1 f1 f1 f1 f1 f1 f1 f1 f1 f1 f1 f1 f1 f1 f1 f1 f1 f1 f1 f1 f1 f1 f1 f1 w1 w1 w1 w1 w1 w1 
w1 f1 f1 f1 w1 w1 w1 w1 w1 w1 w1 w1 w1 w1 w1 w1 w1 w1 w1 w1 w1 w1 w1 w1 w1 w1 w1 w1 w1 w1 w1 w1 f1 f1 f1 f1 f1 f1 f1 f1 f1 f1 f1 f1 w1 w1 w1 w1 w1 w1 
w1 f1 f1 f1 w1 w1 w1 w1 w1 w1 w1 w1 w1 w1 w1 w1 w1 w1 w1 w1 w1 w1 w1 w1 w1 w1 w1 w1 w1 w1 w1 w1 f1 f1 f1 f1 f1 f1 f1 f1 f1 f1 f1 f1 w1 w1 w1 w1 w1 w1 
w1 f1 f1 f1 w1 w1 w1 w1 w1 w1 w1 w1 w1 w1 w1 w1 w1 w1 w1 w1 w1 w1 w1 w1 w1 w1 w1 w1 w1 w1 w1 w1 f1 f1 f1 f1 f1 f1 f1 f1 f1 f1 f1 f1 w1 w1 w1 w1 w1 w1 
w1 f1 f1 f1 f1 f1 f1 f1 f1 f1 f1 f1 f1 f1 w1 w1 w1 w1 w1 w1 w1 w1 w1 w1 w1 w1 w1 w1 w1 w1 w1 w1 w1 w1 w1 w1 f1 f1 f1 f1 f1 f1 f1 f1 w1 w1 w1 w1 w1 w1 
w1 f1 f1 f1 f1 f1 f1 f1 f1 f1 f1 f1 f1 f1 w1 w1 w1 w1 w1 w1 w1 w1 w1 w1 w1 w1 w1 w1 w1 w1 w1 w1 w1 w1 w1 w1 f1 f1 f1 f1 f1 f1 f1 f1 w1 w1 w1 w1 w1 w1 
w1 w1 w1 w1 w1 w1 w1 w1 w1 w1 w1 w1 w1 w1 w1 w1 w1 w1 w1 w1 w1 w1 w1 w1 w1 w1 w1 w1 w1 w1 w1 w1 w1 w1 w1 w1 w1 w1 w1 w1 w1 w1 w1 w1 w1 w1 w1 w1 w1 w1 