0 2500 250 350
w1 w1 w1 w1 w1 w1 w1 w1 w1 w1 w1 w1 w1 w1 w1 w1 w1 w1 w1 w1 w1 w1 w1 w1 w1 w1 w1 w1 w1 w1 w1 w1 w1 w1 w1 w1 w1 w1 w1 w1 w1 w1 w1 w1 w1 w1 w1 w1 w1 w1 
w1 w1 w1 w1 w1 w1 w1 w1 w1 f1 f1 f1 f1 f1 f1 f1 f1 f1 f1 f1 f1 f1 f1 f1 f1 f1 f1 f1 f1 f1 f1 f1 f1 f1 f1 f1 f1 f1 f1 f1 f1 f1 f1 f1 f1 f1 f1 f1 f1 w1 
w1 w1 w1 w1 w1 w1 w1 w1 w1 f1 f1 f1 f1 f1 f1 f1 f1 f1 f1 f1 f1 f1 f1 f1 f1 f1 f1 f1 f1 f1 f1 f1 f1 f1 f1 f1 f1 f1 f1 f1 f1 f1 f1 f1 f1 f1 f1 f1 f1 w1 
w1 w1 f1 f1 f1 w1 w1 w1 w1 f1 f1 f1 f1 f1 f1 f1 f1 f1 f1 f1 f1 f1 f1 f1 f1 f1 f1 f1 f1 f1 f1 f1 f1 f1 f1 f1 f1 f1 f1 f1 f1 f1 f1 f1 f1 f1 f1 f1 f1 w1 
w1 w1 f1 f1 f1 w1 w1 w1 w1 f1 f1 f1 f1 f1 f1 f1 f1 f1 f1 f1 f1 f1 f1 f1 f1 f1 f1 f1 f1 f1 f1 f1 f1 f1 f1 f1 f1 f1 f1 f1 f1 f1 f1 f1 f1 f1 f1 f1 f1 w1 
w1 w1 f1 w1 f1 w1 w1 w1 w1 f1 f1 f1 f1 f1 w1 w1 w1 w1 f1 f1 f1 f1 f1 w1 w1 w1 w1 f1 f1 f1 f1 f1 w1 w1 w1 w1 f1 f1 f1 f1 f1 w1 w1 w1 w1 f1 f1 f1 f1 w1 
w1 w1 f1 f1 f1 w1 w1 w1 w1 f1 f1 f1 f1 f1 w1 w1 w1 w1 f1 f1 f1 f1 f1 w1 w1 w1 w1 f1 f1 f1 f1 f1 w1 w1 w1 w1 f1 f1 f1 f1 f1 w1 w1 w1 w1 f1 f1 f1 f1 w1 
w1 w1 f1 f1 f1 w1 w1 w1 w1 f1 f1 f1 f1 f1 w1 w1 w1 w1 f1 f1 f1 f1 f1 w1 w1 w1 w1 f1 f1 f1 f1 f1 w1 w1 w1 w1 f1 f1 f1 f1 f1 w1 w1 w1 w1 f1 f1 f1 f1 w1 
w1 w1 f1 f1 f1 w1 w1 w1 w1 f1 f1 f1 f1 f1 w1 w1 w1 w1 f1 f1 f1 f1 f1 w1 w1 w1 w1 f1 f1 f1 f1 f1 w1 w1 w1 w1 f1 f1 f1 f1 f1 w1 w1 w1 w1 f1 f1 f1 f1 w1 
w1 w1 f1 f1 f1 w1 w1 w1 w1 f1 f1 f1 f1 f1 f1 f1 f1 f1 f1 f1 f1 f1 f1 f1 f1 f1 f1 f1 f1 f1 f1 f1 f1 f1 f1 f1 f1 f1 f1 f1 f1 f1 f1 f1 f1 f1 f1 f1 f1 w1 
w1 w1 f1 f1 f1 w1 w1 w1 w1 f1 f1 f1 f1 f1 f1 f1 f1 f1 f1 f1 f1 f1 f1 f1 f1 f1 f1 f1 f1 f1 f1 f1 f1 f1 f1 f1 f1 f1 f1 f1 f1 f1 f1 f1 f1 f1 f1 f1 f1 w1 
w1 w1 f1 f1 f1 w1 w1 w1 w1 f1 f1 f1 f1 f1 f1 f1 f1 f1 f1 f1 f1 f1 f1 f1 f1 f1 f1 f1 f1 f1 f1 f1 f1 f1 f1 f1 f1 f1 f1 f1 f1 f1 f1 f1 f1 f1 f1 f1 f1 w1 
w1 w1 f1 f1 f1 w1 w1 w1 w1 f1 f1 f1 f1 f1 f1 f1 f1 f1 f1 f1 f1 f1 f1 f1 f1 f1 f1 f1 f1 f1 f1 f1 f1 f1 f1 f1 f1 f1 f1 f1 f1 f1 f1 f1 f1 f1 f1 f1 f1 w1 
w1 w1 f1 f1 f1 w1 w1 w1 w1 f1 f1 f1 f1 f1 f1 f1 f1 f1 f1 f1 f1 f1 f1 f1 f1 f1 f1 f1 f1 f1 f1 f1 f1 f1 f1 f1 f1 f1 f1 f1 f1 f1 f1 f1 f1 f1 f1 f1 f1 w1 
w1 w1 f1 f1 f1 w1 w1 w1 w1 f1 f1 f1 f1 f1 w1 w1 w1 w1 f1 f1 f1 f1 f1 w1 w1 w1 w1 f1 f1 f1 f1 f1 w1 w1 w1 w1 f1 f1 f1 f1 f1 w1 w1 w1 w1 f1 f1 f1 f1 w1 
w1 w1 f1 f1 f1 w1 w1 w1 w1 f1 f1 f1 f1 f1 w1 w1 w1 w1 f1 f1 f1 f1 f1 w1 w1 w1 w1 f1 f1 f1 f1 f1 w1 w1 w1 w1 f1 f1 f1 f1 f1 w1 w1 w1 w1 f1 f1 f1 f1 w1 
w1 w1 f1 f1 f1 w1 w1 w1 w1 f1 f1 f1 f1 f1 w1 w1 w1 w1 f1 f1 f1 f1 f1 w1 w1 w1 w1 f1 f1 f1 f1 f1 w1 w1 w1 w1 f1 f1 f1 f1 f1 w1 w1 w1 w1 f1 f1 f1 f1 w1 
w1 w1 f1 f1 f1 w1 w1 w1 w1 f1 f1 f1 f1 f1 w1 w1 w1 w1 f1 f1 f1 f1 f1 w1 w1 w1 w1 f1 f1 f1 f1 f1 w1 w1 w1 w1 f1 f1 f1 f1 f1 w1 w1 w1 w1 f1 f1 f1 f1 w1 
w1 w1 f1 f1 f1 w1 w1 w1 w1 f1 f1 f1 f1 f1 f1 f1 f1 f1 f1 f1 f1 f1 f1 f1 f1 f1 f1 f1 f1 f1 f1 f1 f1 f1 f1 f1 f1 f1 f1 f1 f1 f1 f1 f1 f1 f1 f1 f1 f1 w1 
w1 w1 f1 f1 f1 w1 w1 w1 w1 f1 f1 f1 f1 f1 f1 f1 f1 f1 f1 f1 f1 f1 f1 f1 f1 f1 f1 f1 f1 f1 f1 f1 f1 f1 f1 f1 f1 f1 f1 f1 f1 f1 f1 f1 f1 f1 f1 f1 f1 w1 
w1 w1 f1 f1 f1 w1 w1 w1 w1 f1 f1 f1 f1 f1 f1 f1 f1 f1 f1 f1 f1 f1 f1 f1 f1 f1 f1 f1 f1 f1 f1 f1 f1 f1 f1 f1 f1 f1 f1 f1 f1 f1 f1 f1 f1 f1 f1 f1 f1 w1 
w1 w1 f1 f1 f1 w1 w1 w1 w1 f1 f1 f1 f1 f1 f1 f1 f1 f1 f1 f1 f1 f1 f1 f1 f1 f1 f1 f1 f1 f1 f1 f1 f1 f1 f1 f1 f1 f1 f1 f1 f1 f1 f1 f1 f1 f1 f1 f1 f1 w1 
w1 w1 f1 f1 f1 w1 w1 w1 w1 f1 f1 f1 f1 f1 f1 f1 f1 f1 f1 f1 f1 f1 f1 f1 f1 f1 f1 f1 f1 f1 f1 f1 f1 f1 f1 f1 f1 f1 f1 f1 f1 f1 f1 f1 f1 f1 f1 f1 f1 w1 
w1 w1 f1 f1 f1 w1 w1 w1 w1 f1 f1 f1 f1 f1 w1 w1 w1 w1 f1 f1 f1 f1 f1 w1 w1 w1 w1 f1 f1 f1 f1 f1 w1 w1 w1 w1 f1 f1 f1 f1 f1 w1 w1 w1 w1 f1 f1 f1 f1 w1 
w1 w1 f1 f1 f1 w1 w1 w1 w1 f1 f1 f1 f1 f1 w1 w1 w1 w1 f1 f1 f1 f1 f1 w1 w1 w1 w1 f1 f1 f1 f1 f1 w1 w1 w1 w1 f1 f1 f1 f1 f1 w1 w1 w1 w1 f1 f1 f1 f1 w1 
w1 w1 f1 f1 f1 w1 w1 w1 w1 f1 f1 f1 f1 f1 w1 w1 w1 w1 f1 f1 f1 f1 f1 w1 w1 w1 w1 f1 f1 f1 f1 f1 w1 w1 w1 w1 f1 f1 f1 f1 f1 w1 w1 w1 w1 f1 f1 f1 f1 w1 
w1 w1 f1 f1 f1 w1 w1 w1 w1 f1 f1 f1 f1 f1 w1 w1 w1 w1 f1 f1 f1 f1 f1 w1 w1 w1 w1 f1 f1 f1 f1 f1 w1 w1 w1 w1 f1 f1 f1 f1 f1 w1 w1 w1 w1 f1 f1 f1 f1 w1 
w1 w1 f1 f1 f1 w1 w1 w1 w1 f1 f1 f1 f1 f1 f1 f1 f1 f1 f1 f1 f1 f1 f1 f1 f1 f1 f1 f1 f1 f1 f1 f1 f1 f1 f1 f1 f1 f1 f1 f1 f1 f1 f1 f1 f1 f1 f1 f1 f1 w1 
w1 w1 f1 f1 f1 w1 w1 w1 w1 f1 f1 f1 f1 f1 f1 f1 f1 f1 f1 f1 f1 f1 f1 f1 f1 f1 f1 f1 f1 f1 f1 f1 f1 f1 f1 f1 f1 f1 f1 f1 f1 f1 f1 f1 f1 f1 f1 f1 f1 w1 
w1 w1 f1 f1 f1 w1 w1 w1 w1 f1 f1 f1 f1 f1 f1 f1 f1 f1 f1 f1 f1 f1 f1 f1 f1 f1 f1 f1 f1 f1 f1 f1 f1 f1 f1 f1 f1 f1 f1 f1 f1 f1 f1 f1 f1 f1 f1 f1 f1 w1 
w1 w1 f1 f1 f1 w1 w1 w1 w1 f1 f1 f1 f1 f1 f1 f1 f1 f1 f1 f1 f1 f1 f1 f1 f1 f1 f1 f1 f1 f1 f1 f1 f1 f1 f1 f1 f1 f1 f1 f1 f1 f1 f1 f1 f1 f1 f1 f1 f1 w1 
w1 w1 f1 f1 f1 w1 w1 w1 w1 f1 f1 f1 f1 f1 f1 f1 f1 f1 f1 f1 f1 f1 f1 f1 f1 f1 f1 f1 f1 f1 f1 f1 f1 f1 f1 f1 f1 f1 f1 f1 f1 f1 f1 f1 f1 f1 f1 f1 f1 w1 
w1 w1 f1 f1 f1 w1 w1 w1 w1 f1 f1 f1 f1 f1 w1 w1 w1 w1 f1 f1 f1 f1 f1 w1 w1 w1 w1 f1 f1 f1 f1 f1 w1 w1 w1 w1 f1 f1 f1 f1 f1 w1 w1 w1 w1 f1 f1 f1 f1 w1 
w1 w1 f1 f1 f1 w1 w1 w1 w1 f1 f1 f1 f1 f1 w1 w1 w1 w1 f1 f1 f1 f1 f1 w1 w1 w1 w1 f1 f1 f1 f1 f1 w1 w1 w1 w1 f1 f1 f1 f1 f1 w1 w1 w1 w1 f1 f1 f1 f1 w1 
w1 w1 f1 f1 f1 w1 w1 w1 w1 f1 f1 f1 f1 f1 w1 w1 w1 w1 f1 f1 f1 f1 f1 w1 w1 w1 w1 f1 f1 f1 f1 f1 w1 w1 w1 w1 f1 f1 f1 f1 f1 w1 w1 w1 w1 f1 f1 f1 f1 w1 
w1 w1 f1 f1 f1 w1 w1 w1 w1 f1 f1 f1 f1 f1 w1 w1 w1 w1 f1 f1 f1 f1 f1 w1 w1 w1 w1 f1 f1 f1 f1 f1 w1 w1 w1 w1 f1 f1 f1 f1 f1 w1 w1 w1 w1 f1 f1 f1 f1 w1 
w1 w1 f1 f1 f1 w1 w1 w1 w1 f1 f1 f1 f1 f1 f1 f1 f1 f1 f1 f1 f1 f1 f1 f1 f1 f1 f1 f1 f1 f1 f1 f1 f1 f1 f1 f1 f1 f1 f1 f1 f1 f1 f1 f1 f1 f1 f1 f1 f1 w1 
w1 w1 f1 f1 f1 w1 w1 w1 w1 f1 f1 f1 f1 f1 f1 f1 f1 f1 f1 f1 f1 f1 f1 f1 f1 f1 f1 f1 f1 f1 f1 f1 f1 f1 f1 f1 f1 f1 f1 f1 f1 f1 f1 f1 f1 f1 f1 f1 f1 w1 
w1 w1 f1 f1 f1 w1 w1 w1 w1 f1 f1 f1 f1 f1 f1 f1 f1 f1 f1 f1 f1 f1 f1 f1 f1 f1 f1 f1 f1 f1 f1 f1 f1 f1 f1 f1 f1 f1 f1 f1 f1 f1 f1 f1 f1 f1 f1 f1 f1 w1 
w1 w1 f1 f1 f1 w1 w1 w1 w1 f1 f1 f1 f1 f1 f1 f1 f1 f1 f1 f1 f1 f1 f1 f1 f1 f1 f1 f1 f1 f1 f1 f1 f1 f1 f1 f1 f1 f1 f1 f1 f1 f1 f1 f1 f1 f1 f1 f1 f1 w1 
w1 w1 f1 f1 f1 w1 w1 w1 f1 f1 f1 f1 f1 f1 f1 f1 f1 f1 f1 f1 f1 f1 f1 f1 f1 f1 f1 f1 f1 f1 f1 f1 f1 f1 f1 f1 f1 f1 f1 f1 f1 f1 f1 f1 f1 f1 f1 f1 f1 w1 
w1 w1 f1 f1 f1 w1 w1 f1 f1 f1 w1 w1 w1 w1 w1 w1 w1 w1 w1 w1 w1 w1 w1 w1 w1 w1 w1 w1 w1 w1 w1 w1 w1 w1 w1 w1 w1 w1 w1 w1 w1 w1 w1 w1 w1 w1 w1 w1 w1 w1 
w1 w1 f1 f1 f1 w1 f1 f1 f1 w1 w1 w1 w1 w1 w1 w1 w1 w1 w1 w1 w1 w1 w1 w1 w1 w1 w1 w1 w1 w1 w1 w1 w1 w1 w1 w1 w1 w1 w1 w1 w1 w1 w1 w1 w1 w1 w1 w1 w1 w1 
w1 w1 f1 f1 f1 f1 f1 f1 w1 w1 w1 w1 w1 w1 w1 w1 w1 w1 w1 w1 w1 w1 w1 w1 w1 w1 w1 w1 w1 w1 w1 w1 w1 w1 w1 w1 w1 w1 w1 w1 w1 w1 w1 w1 w1 w1 w1 w1 w1 w1 
w1 w1 f1 f1 f1 w1 f1 w1 w1 w1 w1 w1 w1 w1 w1 w1 w1 w1 w1 w1 w1 w1 w1 w1 w1 w1 w1 w1 w1 w1 w1 w1 w1 w1 w1 w1 w1 w1 w1 w1 w1 w1 w1 w1 w1 w1 w1 w1 w1 w1 
w1 w1 f1 f1 f1 f1 f1 f1 f1 f1 f1 f1 f1 f1 f1 f1 f1 f1 f1 f1 f1 f1 f1 f1 f1 f1 f1 f1 f1 f1 f1 f1 f1 f1 f1 f1 f1 f1 f1 f1 f1 f1 f1 f1 f1 f1 f1 w1 w1 w1 
w1 w1 f1 f1 f1 f1 f1 f1 f1 f1 f1 f1 f1 f1 f1 f1 f1 f1 f1 f1 f1 f1 f1 f1 f1 f1 f1 f1 f1 f1 f1 f1 f1 f1 f1 f1 f1 f1 f1 f1 f1 f1 f1 f1 w1 f1 f1 w1 w1 w1 
w1 f1 f1 f1 f1 f1 f1 f1 f1 f1 f1 f1 f1 f1 f1 f1 f1 f1 f1 f1 f1 f1 f1 f1 f1 f1 f1 f1 f1 f1 f1 f1 f1 f1 f1 f1 f1 f1 f1 f1 f1 f1 f1 f1 f1 f1 f1 w1 w1 w1 
w1 f1 f1 w1 w1 w1 w1 w1 w1 w1 w1 w1 w1 w1 w1 w1 w1 w1 w1 w1 w1 w1 w1 w1 w1 w1 w1 w1 w1 w1 w1 w1 w1 w1 w1 w1 w1 w1 w1 w1 w1 w1 w1 w1 w1 w1 w1 w1 w1 w1 
w1 w1 w1 w1 w1 w1 w1 w1 w1 w1 w1 w1 w1 w1 w1 w1 w1 w1 w1 w1 w1 w1 w1 w1 w1 w1 w1 w1 w1 w1 w1 w1 w1 w1 w1 w1 w1 w1 w1 w1 w1 w1 w1 w1 w1 w1 w1 w1 w1 w1 