w1 w1 w1 w1 w1 f1 f1 f1 f1 f1 f1 f1 f1 f1 f1 f1 f1 f1 f1 f1 f1 f1 f1 f1 f1 f1 f1 f1 f1 f1 f1 f1 f1 f1 f1 f1 f1 f1 f1 f1 f1 f1 f1 f1 f1 f1 f1 f1 f1 f1
w1 w1 w1 w1 w1 f1 f1 f1 f1 f1 f1 f1 f1 f1 f1 f1 f1 f1 f1 f1 f1 f1 f1 f1 f1 f1 f1 f1 f1 f1 f1 f1 f1 f1 f1 f1 f1 f1 f1 f1 f1 f1 f1 f1 f1 f1 f1 f1 f1 f1
w1 w1 w1 w1 w1 f1 f1 f1 f1 f1 f1 f1 f1 f1 f1 f1 f1 f1 f1 f1 f1 f1 f1 f1 f1 f1 f1 f1 f1 f1 f1 f1 f1 f1 f1 f1 f1 f1 f1 f1 f1 f1 f1 f1 f1 f1 f1 f1 f1 f1
w1 w1 w1 w1 w1 f1 f1 f1 f1 f1 f1 f1 f1 f1 f1 f1 f1 f1 f1 f1 f1 f1 f1 f1 f1 f1 f1 f1 f1 f1 f1 f1 f1 f1 f1 f1 f1 f1 f1 f1 f1 f1 f1 f1 f1 f1 f1 f1 f1 f1
w1 w1 w1 w1 w1 f1 f1 f1 f1 f1 f1 f1 f1 f1 f1 f1 f1 f1 f1 f1 f1 f1 f1 f1 f1 f1 f1 f1 f1 f1 f1 f1 f1 f1 f1 f1 f1 f1 f1 f1 f1 f1 f1 f1 f1 f1 f1 f1 f1 f1
w1 w1 w1 w1 w1 f1 f1 f1 f1 f1 f1 f1 f1 f1 f1 f1 f1 f1 f1 f1 f1 f1 f1 f1 f1 f1 f1 f1 f1 f1 f1 f1 f1 f1 f1 f1 f1 f1 f1 f1 f1 f1 f1 f1 f1 f1 f1 f1 f1 f1
w1 w1 w1 w1 w1 f1 f1 f1 f1 f1 f1 f1 f1 f1 f1 f1 f1 f1 f1 f1 f1 f1 f1 f1 f1 f1 f1 f1 f1 f1 f1 f1 f1 f1 f1 f1 f1 f1 f1 f1 f1 f1 f1 f1 f1 f1 f1 f1 f1 f1
w1 w1 w1 w1 w1 f1 f1 f1 f1 f1 f1 f1 f1 f1 f1 f1 f1 f1 f1 f1 f1 f1 f1 f1 f1 f1 f1 f1 f1 f1 f1 f1 f1 f1 f1 f1 f1 f1 f1 f1 f1 f1 f1 f1 f1 f1 f1 f1 f1 f1
w1 w1 w1 w1 w1 f1 f1 f1 f1 f1 f1 f1 f1 f1 f1 f1 f1 f1 f1 f1 f1 f1 f1 f1 f1 f1 f1 f1 f1 f1 f1 f1 f1 f1 f1 f1 f1 f1 f1 f1 f1 f1 f1 f1 f1 f1 f1 f1 f1 f1
f1 f1 f1 f1 f1 f1 f1 f1 f1 f1 f1 f1 f1 f1 f1 f1 f1 f1 f1 f1 f1 f1 f1 f1 f1 f1 f1 f1 f1 f1 f1 f1 f1 f1 f1 f1 f1 f1 f1 f1 f1 f1 f1 f1 f1 f1 f1 f1 f1 f1
f1 f1 f1 f1 f1 f1 f1 f1 f1 f1 f1 f1 f1 f1 f1 f1 f1 f1 f1 f1 f1 f1 f1 f1 f1 f1 f1 f1 f1 f1 f1 f1 f1 f1 f1 f1 f1 f1 f1 f1 f1 f1 f1 f1 f1 f1 f1 f1 f1 f1
f1 f1 f1 f1 f1 f1 f1 f1 f1 f1 f1 f1 f1 f1 f1 f1 f1 f1 f1 f1 f1 f1 f1 f1 f1 f1 f1 f1 f1 f1 f1 f1 f1 f1 f1 f1 f1 f1 f1 f1 f1 f1 f1 f1 f1 f1 f1 f1 f1 f1
f1 f1 f1 f1 f1 f1 f1 f1 f1 f1 f1 f1 f1 f1 f1 f1 f1 f1 f1 f1 f1 f1 f1 f1 f1 f1 f1 f1 f1 f1 f1 f1 f1 f1 f1 f1 f1 f1 f1 f1 f1 f1 f1 f1 f1 f1 f1 f1 f1 f1
f1 f1 f1 f1 f1 f1 f1 f1 f1 f1 f1 f1 f1 f1 f1 f1 f1 f1 f1 f1 f1 f1 f1 f1 f1 f1 f1 f1 f1 f1 f1 f1 f1 f1 f1 f1 f1 f1 f1 f1 f1 f1 f1 f1 f1 f1 f1 f1 f1 f1
f1 f1 f1 f1 w1 w1 w1 f1 f1 f1 f1 f1 f1 f1 f1 f1 f1 f1 f1 f1 f1 f1 f1 f1 f1 f1 f1 f1 f1 f1 f1 f1 f1 f1 f1 f1 f1 f1 f1 f1 f1 f1 f1 f1 f1 f1 f1 f1 f1 f1
f1 f1 f1 f1 w1 w1 w1 f1 f1 f1 f1 f1 f1 f1 f1 f1 f1 f1 f1 f1 f1 f1 f1 f1 f1 f1 f1 f1 f1 f1 f1 f1 f1 f1 f1 f1 f1 f1 f1 f1 f1 f1 f1 f1 f1 f1 f1 f1 f1 f1
f1 f1 f1 f1 w1 w1 w1 f1 f1 f1 f1 f1 f1 f1 f1 f1 f1 f1 f1 f1 f1 f1 f1 f1 f1 f1 f1 f1 f1 f1 f1 f1 f1 f1 f1 f1 f1 f1 f1 f1 f1 f1 f1 f1 f1 f1 f1 f1 f1 f1
f1 f1 f1 f1 w1 w1 w1 f1 f1 f1 f1 f1 f1 f1 f1 f1 f1 f1 f1 f1 f1 f1 f1 f1 f1 f1 f1 f1 f1 f1 f1 f1 f1 f1 f1 f1 f1 f1 f1 f1 f1 f1 f1 f1 f1 f1 f1 f1 f1 f1
f1 f1 f1 f1 w1 w1 w1 f1 f1 f1 f1 f1 f1 f1 f1 f1 f1 f1 f1 f1 f1 f1 f1 f1 f1 f1 f1 f1 f1 f1 f1 f1 f1 f1 f1 f1 f1 f1 f1 f1 f1 f1 f1 f1 f1 f1 f1 f1 f1 f1
f1 f1 f1 f1 w1 w1 w1 f1 f1 f1 f1 f1 f1 f1 f1 f1 f1 f1 f1 f1 f1 f1 f1 f1 f1 f1 f1 f1 f1 f1 f1 f1 f1 f1 f1 f1 f1 f1 f1 f1 f1 f1 f1 f1 f1 f1 f1 f1 f1 f1
f1 f1 f1 f1 w1 w1 w1 f1 f1 f1 f1 f1 f1 f1 f1 f1 f1 f1 f1 f1 f1 f1 f1 f1 f1 f1 f1 f1 f1 f1 f1 f1 f1 f1 f1 f1 f1 f1 f1 f1 f1 f1 f1 f1 f1 f1 f1 f1 f1 f1
f1 f1 f1 f1 w1 w1 w1 f1 f1 f1 f1 f1 f1 f1 f1 f1 f1 f1 f1 f1 f1 f1 f1 f1 f1 f1 f1 f1 f1 f1 f1 f1 f1 f1 f1 f1 f1 f1 f1 f1 f1 f1 f1 f1 f1 f1 f1 f1 f1 f1
f1 f1 f1 f1 w1 w1 w1 f1 f1 f1 f1 f1 f1 f1 f1 f1 f1 f1 f1 f1 f1 f1 f1 f1 f1 f1 f1 f1 f1 f1 f1 f1 f1 f1 f1 f1 f1 f1 f1 f1 f1 f1 f1 f1 f1 f1 f1 f1 f1 f1
f1 f1 f1 f1 w1 w1 w1 f1 f1 f1 f1 f1 f1 f1 f1 f1 f1 f1 f1 f1 f1 f1 f1 f1 f1 f1 f1 f1 f1 f1 f1 f1 f1 f1 f1 f1 f1 f1 f1 f1 f1 f1 f1 f1 f1 f1 f1 f1 f1 f1
f1 f1 f1 f1 w1 w1 w1 f1 f1 f1 f1 f1 f1 f1 f1 f1 f1 f1 f1 f1 f1 f1 f1 f1 f1 f1 f1 f1 f1 f1 f1 f1 f1 f1 f1 f1 f1 f1 f1 f1 f1 f1 f1 f1 f1 f1 f1 f1 f1 f1
f1 f1 f1 f1 w1 w1 w1 f1 f1 f1 f1 f1 f1 f1 f1 f1 f1 f1 f1 f1 f1 f1 f1 f1 f1 f1 f1 f1 f1 f1 f1 f1 f1 f1 f1 f1 f1 f1 f1 f1 f1 f1 f1 f1 f1 f1 f1 f1 f1 f1
f1 f1 f1 f1 w1 w1 w1 f1 f1 f1 f1 f1 f1 f1 f1 f1 f1 f1 f1 f1 f1 f1 f1 f1 f1 f1 f1 f1 f1 f1 f1 f1 f1 f1 f1 f1 f1 f1 f1 f1 f1 f1 f1 f1 f1 f1 f1 f1 f1 f1
f1 f1 f1 f1 w1 w1 w1 f1 f1 f1 f1 f1 f1 f1 f1 f1 f1 f1 f1 f1 f1 f1 f1 f1 f1 f1 f1 f1 f1 f1 f1 f1 f1 f1 f1 f1 f1 f1 f1 f1 f1 f1 f1 f1 f1 f1 f1 f1 f1 f1
f1 f1 f1 f1 w1 w1 w1 f1 f1 f1 f1 f1 f1 f1 f1 f1 f1 f1 f1 f1 f1 f1 f1 f1 f1 f1 f1 f1 f1 f1 f1 f1 f1 f1 f1 f1 f1 f1 f1 f1 f1 f1 f1 f1 f1 f1 f1 f1 f1 f1
f1 f1 f1 f1 w1 w1 w1 f1 f1 f1 f1 f1 f1 f1 f1 f1 f1 f1 f1 f1 f1 f1 f1 f1 f1 f1 f1 f1 f1 f1 f1 f1 f1 f1 f1 f1 f1 f1 f1 f1 f1 f1 f1 f1 f1 f1 f1 f1 f1 f1
f1 f1 f1 f1 w1 w1 w1 f1 f1 f1 f1 f1 f1 f1 f1 f1 f1 f1 f1 f1 f1 f1 f1 f1 f1 f1 f1 f1 f1 f1 f1 f1 f1 f1 f1 f1 f1 f1 f1 f1 f1 f1 f1 f1 f1 f1 f1 f1 f1 f1
f1 f1 f1 f1 w1 w1 w1 f1 f1 f1 f1 f1 f1 f1 f1 f1 f1 f1 f1 f1 f1 f1 f1 f1 f1 f1 f1 f1 f1 f1 f1 f1 f1 f1 f1 f1 f1 f1 f1 f1 f1 f1 f1 f1 f1 f1 f1 f1 f1 f1
f1 f1 f1 f1 w1 w1 w1 f1 f1 f1 f1 f1 f1 f1 f1 f1 f1 f1 f1 f1 f1 f1 f1 f1 f1 f1 f1 f1 f1 f1 f1 f1 f1 f1 f1 f1 f1 f1 f1 f1 f1 f1 f1 f1 f1 f1 f1 f1 f1 f1
f1 f1 f1 f1 w1 w1 w1 f1 f1 f1 f1 f1 f1 f1 f1 f1 f1 f1 f1 f1 f1 f1 f1 f1 f1 f1 f1 f1 f1 f1 f1 f1 f1 f1 f1 f1 f1 f1 f1 f1 f1 f1 f1 f1 f1 f1 f1 f1 f1 f1
f1 f1 f1 f1 w1 w1 w1 f1 f1 f1 f1 f1 f1 f1 f1 f1 f1 f1 f1 f1 f1 f1 f1 f1 f1 f1 f1 f1 f1 f1 f1 f1 f1 f1 f1 f1 f1 f1 f1 f1 f1 f1 f1 f1 f1 f1 f1 f1 f1 f1
f1 f1 f1 f1 w1 w1 w1 f1 f1 f1 f1 f1 f1 f1 f1 f1 f1 f1 f1 f1 f1 f1 f1 f1 f1 f1 f1 f1 f1 f1 f1 f1 f1 f1 f1 f1 f1 f1 f1 f1 f1 f1 f1 f1 f1 f1 f1 f1 f1 f1
f1 f1 f1 f1 w1 w1 w1 f1 f1 f1 f1 f1 f1 f1 f1 f1 f1 f1 f1 f1 f1 f1 f1 f1 f1 f1 f1 f1 f1 f1 f1 f1 f1 f1 f1 f1 f1 f1 f1 f1 f1 f1 f1 f1 f1 f1 f1 f1 f1 f1
f1 f1 f1 f1 w1 w1 w1 f1 f1 f1 f1 f1 f1 f1 f1 f1 f1 f1 f1 f1 f1 f1 f1 f1 f1 f1 f1 f1 f1 f1 f1 f1 f1 f1 f1 f1 f1 f1 f1 f1 f1 f1 f1 f1 f1 f1 f1 f1 f1 f1
f1 f1 f1 f1 w1 w1 w1 f1 f1 f1 f1 f1 f1 f1 f1 f1 f1 f1 f1 f1 f1 f1 f1 f1 f1 f1 f1 f1 f1 f1 f1 f1 f1 f1 w1 w1 w1 w1 w1 w1 w1 w1 w1 w1 f1 f1 f1 f1 f1 f1
w1 w1 w1 w1 w1 w1 w1 f1 f1 f1 f1 f1 f1 f1 f1 f1 f1 f1 f1 f1 f1 f1 f1 f1 f1 f1 f1 f1 f1 f1 f1 f1 f1 f1 w1 w1 w1 w1 w1 w1 w1 w1 w1 w1 f1 f1 f1 f1 f1 f1
w1 w1 w1 w1 w1 w1 w1 f1 f1 f1 f1 f1 f1 f1 f1 f1 f1 f1 f1 f1 f1 f1 f1 f1 f1 f1 f1 f1 f1 f1 f1 f1 f1 f1 w1 w1 w1 w1 w1 f1 f1 f1 f1 f1 f1 f1 f1 f1 f1 f1
w1 w1 w1 w1 w1 w1 w1 w1 w1 w1 w1 w1 w1 w1 w1 w1 w1 w1 w1 w1 w1 w1 w1 w1 w1 w1 w1 w1 w1 w1 f1 f1 f1 f1 w1 w1 w1 w1 w1 f1 f1 f1 f1 f1 f1 f1 f1 f1 f1 f1
w1 w1 w1 w1 w1 w1 w1 w1 w1 w1 w1 w1 w1 w1 w1 w1 w1 w1 w1 w1 w1 w1 w1 w1 w1 w1 w1 w1 w1 w1 f1 f1 f1 f1 f1 f1 f1 f1 f1 f1 f1 f1 f1 f1 f1 f1 f1 f1 f1 f1
f1 f1 f1 f1 f1 f1 f1 f1 f1 f1 f1 f1 f1 f1 f1 f1 f1 f1 f1 f1 f1 f1 f1 f1 f1 f1 f1 f1 f1 f1 f1 f1 f1 f1 f1 f1 f1 f1 f1 f1 f1 f1 f1 f1 f1 w1 w1 w1 w1 w1
f1 f1 f1 f1 f1 f1 f1 f1 f1 f1 f1 f1 f1 f1 f1 f1 f1 f1 f1 f1 f1 f1 f1 f1 f1 f1 f1 f1 f1 f1 f1 f1 f1 f1 f1 f1 f1 f1 f1 f1 f1 f1 f1 f1 f1 w1 w1 w1 w1 w1
f1 f1 f1 f1 f1 f1 f1 f1 f1 f1 f1 f1 f1 f1 f1 f1 f1 f1 f1 f1 f1 f1 f1 f1 f1 f1 f1 f1 f1 f1 f1 f1 f1 f1 f1 f1 f1 f1 f1 f1 f1 f1 f1 f1 f1 w1 w1 w1 w1 w1
f1 f1 f1 f1 f1 f1 f1 f1 f1 f1 f1 f1 f1 f1 f1 f1 f1 f1 f1 f1 f1 f1 f1 f1 f1 f1 f1 f1 f1 f1 f1 f1 f1 f1 f1 f1 f1 f1 f1 f1 f1 f1 f1 f1 f1 w1 w1 w1 w1 w1
f1 f1 f1 f1 f1 f1 f1 f1 w1 w1 w1 w1 w1 w1 w1 w1 w1 w1 w1 w1 w1 w1 w1 w1 w1 w1 w1 w1 w1 w1 w1 w1 w1 w1 w1 f1 f1 f1 f1 f1 f1 f1 f1 f1 f1 w1 w1 w1 w1 w1
f1 f1 f1 f1 f1 f1 f1 f1 f1 f1 f1 f1 w1 w1 w1 w1 w1 w1 w1 w1 w1 w1 w1 w1 w1 w1 w1 w1 w1 w1 w1 w1 w1 w1 w1 w1 w1 f1 f1 f1 f1 f1 f1 f1 f1 w1 w1 w1 w1 w1
f1 f1 f1 f1 f1 f1 f1 f1 f1 f1 f1 f1 w1 w1 w1 w1 w1 w1 w1 w1 w1 w1 w1 w1 w1 w1 w1 w1 w1 w1 w1 w1 w1 w1 w1 w1 w1 f1 f1 f1 f1 f1 f1 f1 f1 w1 w1 w1 w1 w1